#########                 #########
#   ###################   # #   #
# ####                # # # # # # #
# ################### # # # # # # #
#                     # # # # # # #
##################### # # # # # # #
#   ##                # # # # # # #
# # ## ### ## ######### # # # # # #
# #    #   ##B#         # # # # # #
# # ## ################ # # # # # #
### ##             #### # # # # # #
### ############## ## # # # # # # #
###             ##    # # # # # # #
###### ######## ####### # # # # # #
###### ####             #   #     #
A      ############################
