#### B
#    #
# ####
# ####
# ###
#
#A####