######################
#A   #            #   #
# ### # ######### # # #
#   #   #         # # #
# # ##### ####### # ###
# #   #   #       #   #
### # ### # ###########
#     #   #         # #
##### # ### ### ### # #
#     #   #     #   # #
# ### ### # ##### ### #
#     #   #     #   # #
# ### # ### ##### # # #
# #   #   #       #   #
# # ### ### ######### #
#   #   #           # #
######################B
