#########################
#A     #   #     #     # #
# ### # # # # ##### ### # #
#   #   # #   # #   #     #
# # ### # ##### # # ##### #
# #   #       #   #       #
# # ######### ### ##### # #
# #       #   #       # # #
# ##### ### ### ####### # #
#     #       #         # #
# ##### ##### ########### #
#   #   #     #       #   #
# ### ### ##### ##### ### #
#   #     #     #   #   # #
### ##### ####### ### ### #
#     #     #   #   #     #
##### # ##### # ### ##### #
#   # #       #   #   #   #
# # ############# ### ### #
#   #               #   #B#
###########################
